Eine neue Welt

==LEVEL==
15, 80
255, 255, 255, 255, 255, 255, 255, 255, 255, 255, 255, 255, 255, 255, 255, 255, 255, 255, 255, 255, 255, 255, 255, 255, 255, 255, 255, 255, 255, 255, 255,   4, 255, 255,   4, 255, 255, 255, 255, 255, 255, 255, 255, 255, 255, 255, 255, 255, 255, 255, 255, 255, 255, 255, 255, 255, 255, 255, 255, 255, 255, 255, 255, 255, 255, 255, 255, 255, 255, 255, 255, 255, 255, 255, 255, 255, 255, 255, 255, 255
255, 255, 255, 255, 255, 255, 255, 255, 255, 255, 255, 255, 255, 255, 255, 255, 255, 255, 255, 255, 255, 255, 255, 255, 255, 255, 255, 255, 255, 255, 255,   4,   4,   4,   4, 255, 255, 255, 255, 255, 255, 255, 255, 255, 255, 255, 255, 255, 255, 255, 255, 255, 255, 255, 255, 255, 255, 255, 255, 255, 255, 255, 255, 255, 255, 255, 255, 255, 255, 255, 255, 255, 255, 255, 255, 255, 255, 255, 255, 255
255, 255, 255, 255, 255, 255, 255, 255, 255, 255, 255, 255, 255, 255, 255, 255, 255, 255, 255, 255, 255, 255, 255, 255, 255, 255, 255, 255, 255, 255, 255, 255, 255, 255, 255, 255, 255, 255, 255, 255, 255, 255, 255, 255, 255, 255, 255, 255, 255, 255, 255, 255, 255, 255, 255, 255, 255, 255, 255, 255, 255, 255, 255, 255, 255, 255, 255, 255, 255, 255, 255, 255, 255, 255, 255, 255, 255, 255, 255, 255
255, 255, 255, 255, 255, 255, 255, 255, 255, 255, 255, 255, 255, 255, 255, 255, 255, 255, 255, 255, 255, 255, 255, 255, 255, 255, 255, 255, 255, 255, 255, 255, 255, 255, 255, 255, 255, 255, 255, 255, 255, 255, 255, 255, 255, 255, 255, 255, 255, 255, 255, 255, 255, 255, 255, 255, 255, 255, 255, 255, 255, 255, 255, 255, 255, 255, 255, 255, 255, 255, 255, 255, 255, 255, 255, 255, 255, 255, 255, 255
255, 255, 255, 255, 255, 255, 255, 255, 255, 255, 255, 255, 255, 255, 255, 255, 255, 255, 255, 255, 255, 255, 255, 255, 255, 255, 255, 255, 255, 255, 255, 255, 255, 255, 255, 255, 255, 255, 255, 255, 255, 255, 255, 255, 255, 255, 255, 255, 255, 255, 255, 255, 255, 255, 255, 255, 255, 255, 255, 255, 255, 255, 255, 255, 255, 255, 255, 255, 255, 255, 255, 255, 255, 255, 255, 255, 255, 255, 255, 255
255, 255, 255, 255, 255, 255, 255, 255, 255, 255, 255, 255, 255, 255, 255, 255, 255, 255, 255, 255, 255, 255, 255,  52,  51,  52, 255, 255, 255, 255, 255, 255, 255, 255, 255, 255, 255, 255, 255, 255, 255, 255, 255, 255, 255, 255, 255, 255, 255, 255, 255, 255, 255, 255, 255, 255, 255, 255, 255, 255, 255, 255, 255, 255, 255, 255, 255, 255, 255, 255, 255, 255, 255, 255, 255, 255, 255, 255, 255, 255
255, 255, 255, 255, 255, 255,  52, 255, 255, 255, 255, 255, 255, 255, 255, 255, 255, 255, 255, 255, 255, 255, 255,  51,  52,  51, 255, 255, 255, 255, 255, 255, 255, 255, 255, 255, 255, 255, 255, 255, 255, 255, 255, 255, 255, 255, 255, 255, 255, 255, 255, 255, 255, 255, 255, 255, 255, 255, 255, 255, 255, 255, 255, 255, 255, 255, 255, 255, 255, 255, 255, 255, 255, 255, 255, 255, 255, 255, 255, 255
255,  51, 255, 255,  53, 255, 255, 255, 255, 255, 255, 255, 255, 255, 255, 255, 255, 255, 255, 255, 255, 255, 255,  52,  51,  52, 255, 255, 255, 255, 255, 255, 255, 255, 255, 255, 255, 255, 255, 255, 255, 255, 255, 255, 255, 255, 255, 255, 255, 255, 255, 255, 255, 255, 255, 255, 255, 255, 255, 255, 255, 255, 255, 255, 255, 255, 255, 255, 255, 255, 255, 255, 255, 255, 255, 255, 255, 255, 255, 255
255, 255, 255,   5,   1,   6, 255, 255, 255, 255, 255, 255, 255, 255, 255, 255, 255, 255, 255, 255, 255, 255, 255,  51,  52,  51, 255, 255, 255, 255, 255, 255, 255, 255, 255, 255, 255, 255, 255, 255, 255, 255, 255, 255, 255, 255, 255, 255, 255, 255, 255, 255, 255, 255, 255, 255, 255, 255, 255, 255, 255, 255, 255, 255, 255, 255, 255, 255, 255, 255, 255, 255, 255, 255, 255, 255, 255, 255, 255, 255
255, 255, 255, 255, 255,  50, 255, 255, 255, 255, 255, 255, 255, 255, 255, 255, 255, 255, 255, 255, 255, 255, 255,  52,  51,  52, 255, 255, 255, 255, 255, 255, 255, 255, 255, 255, 255, 255, 255, 255, 255, 255, 255, 255, 255, 255, 255, 255, 255, 255, 255, 255, 255, 255, 255, 255, 255, 255, 255, 255, 255, 255, 255, 255, 255, 255, 255, 255, 255, 255, 255, 255, 255, 255, 255, 255, 255, 255, 255, 255
255, 255, 255, 255, 255, 255, 255,   0,   2, 255, 255, 255, 255, 255, 255, 255, 255, 255, 255, 255, 255, 255, 255,  51,  52,  51, 255, 255, 255, 255, 255, 255, 255, 255, 255, 255, 255, 255, 255, 255, 255, 255, 255, 255, 255, 255, 255, 255, 255, 255, 255, 255, 255, 255, 255, 255, 255, 255, 255, 255, 255, 255, 255, 255, 255, 255, 255, 255, 255, 255, 255, 255, 255, 255, 255, 255, 255, 255, 255, 255
  2, 255, 255, 255, 255, 255, 255,   4,   4,   2, 255, 255, 255, 255, 255, 255, 255, 255, 255, 255, 255, 255,  56,  52,  51,  52,  56, 255, 255, 255, 255, 255, 255, 255, 255, 255, 255, 255, 255, 255,   3, 255, 255,  56, 255, 255,  56, 255, 255,  56, 255, 255,   3, 255, 255, 255, 255, 255, 255, 255, 255, 255, 255, 255, 255, 255, 255, 255, 255, 255, 255, 255, 255, 255, 255, 255, 255, 255, 255, 255
  4,   2, 255, 255, 255, 255,  56,   4,   4,   4,   2, 255, 255, 255, 255, 255, 255, 255, 255, 255, 255, 255,   0,   1,   1,   1,   2, 255,  53, 255, 255, 255, 255, 255, 255, 255, 255,  53, 255,   0,   4, 255, 255,   3, 255, 255,   3, 255, 255,   3, 255, 255,   4,   2, 255, 255, 255, 255,   3, 255, 255, 255, 255, 255, 255, 255, 255, 255, 255, 255, 255, 255, 255, 255, 255, 255, 255, 255,  55, 255
  4,   4,   1,   1,   1,   1,   1,   4,   4,   4,   4,   1,   1,   1,   1,   1,   1,   1,   1,   1,   1,   1,   4,   4,   4,   4,   4,   1,   1,   2, 255, 255, 255, 255, 255, 255,   0,   1,   1,   4,   4, 255, 255,   4, 255, 255,   4, 255, 255,   4, 255, 255,   4,   4,   1,   1,   1,   1,   4,   1,   1,   1,   1,   1,   2,   7,   7,   7,   7,   7,   7,   7,   7,   7,   7,   0,   1,   1,   1,   1
  4,   4,   4,   4,   4,   4,   4,   4,   4,   4,   4,   4,   4,   4,   4,   4,   4,   4,   4,   4,   4,   4,   4,   4,   4,   4,   4,   4,   4,   4, 255, 255, 255, 255, 255, 255,   4,   4,   4,   4,   4, 255, 255,   4, 255, 255,   4, 255, 255,   4, 255, 255,   4,   4,   4,   4,   4,   4,   4,   4,   4,   4,   4,   4,   4, 255, 255, 255, 255, 255, 255, 255, 255, 255, 255,   4,   4,   4,   4,   4

==PLAYER==
0,10

==ENEMYS==
4,12
11,12
32,0
56,12

==TRIGGERS==
4,7,12,12,52
4,7,14,12,51
4,7,16,12,50
4,7,18,12,51
4,7,20,12,52
28,12,32,1,255
28,12,33,1,255
28,12,32,13,5
28,12,33,13,6
37,12,32,13,255
37,12,33,13,255
66,12,65,13,255
67,12,66,13,255
68,12,67,13,255
69,12,68,13,255
70,12,69,13,255
71,12,70,13,255
72,12,71,13,255
73,12,72,13,255
74,12,73,13,255
75,12,74,13,255

